00000000000000000000000000000000000000000000000000000000000000000000000000000000000000000000000000000
00000000000000000000000000000000000000000000000000000000000000000000000000000000000000000000000000000
00000000000000000000000000000000000000000000000000000000000000000000000000000000000000000000000000000
00001111111111000000000000000000000000000000000000000000000100000000000000000000000000000000000000000
00000000000000110000000000000000000100000000010000000000000000000000000000000000000000010000011100000
00000110110110110000000010000000000000000000000000000000000000000000010000000000000000000000011100000
00000000000000000000000000000000000000000000000000000000000000000000000000000000000000000000000000000
00000000000000000000000000000000000000000001000000000000000000000000000000000000000000000000000000000
00000110110110000000000000000000000000000000000000000000000000000000000000010000100000000000000001000
00000000000000000000000000000000000000000000000000000000000000000000000000000000000000000000000000000
00000000000000000000000000000000000000000000000000000000001000000000000000000000000000000000000000000
00000110110110000000000000000011111111111111111111111111111111111111111111111111111111111111111111110
00000000000000001000000000000011111100000000000000000000000000000000011111010000000000000000000000000
00001111111111000000000000000011111100000000000000000000000000000000001110000000000000000000001111100
00000000000000000000000000000011111000000000000000000000000000000000000000000000000000000000001111100
00000000000000000000000000000011000000000000000000000000000000000000000000000000000000000000000000000
00000000000000000000000001000000000000000000000000000000000000000000000000000000000000000000000000000
00000000100000000000000000000000000000000000000000000000000000000000000000000000000000000000000000000
00000000000000000000000000000000000000000000000011111111111111111111111111111111111111111111111111100
00010000000000000000000000000000000000000000000011111111111111111111111111111111111111111111111111100
00000000000000000000000000000000000000000000000011111111111111111111111111111111111111111111111111100
00000000000000010000111111111100000000000000000011111111111111111111111111111111111111111111111111100
00000000000000000000000000000000000000000000000000000000000000000000000000000000000000000000000000000
00000000000000000000000000000000000000000000000000000000000000000000000000000000000000000000000000000
00000000000000000000011000000000000000000000000000000000000000000000000000000000000000000000000000000
00000000000000000000011000000000000000000000000000000000000000000000000000000000000000000000000000000
00000000000000000000000000000000000000000000000000000000000000000000000000000000000000000000000000000
00000010000000000000000000000000000000000000000000001111111111111111111111111111111111111111111111100
00000000000000000000000000000000000000000000000000001111111111111111111111111111111111111111111111100
00000000000000000000000000000000000000000000000000001111111111111111111111111111111111111111111111100
00000000000000000000000000000000000000000000000000001111111111111111111111111111111111111111111111100
00000000000000000000000000000000000000000000000000000000000000000000000000000000000000000000000000000
00000000000000000000000000000000000000000000000000000000000000000000000000000000000000000000000000000
00000000000000000000000000000000000000000000000000000000000000000000000000000000000000000000000000000
00010000000000000000000000000000000000000000000000000000000000000000000000000000000000000000000000000
00000000000000000000000000000000000000000000000000000000000000000000000000000000000000000000000000000
00000000000000011111000000000000000000000000000000000000000000000000000000000000000000000000000000000
00000000000000001111000000000000000000000000000000000000011110001111000111100011110001111000000000000
00000000000000000000000000000000000000000000000000000000011110001111000111100011110001111000000000000
00000100000000001111000000000000000000000000000000000000011110001111000111100011110001111000000000000
00000000000000001111000000000000000000000000000000000000011110001111000111100011110001111000000000000
00000000000000001111000000000000000000000000000000000000011110001111000111100011110001111000000000000
00000000000000000000000000000000000000000000000000000000000000000000000000000000000000000000000000000
00000000000000001111000000000000000000000000000000000000000000000000000000000000000000000000000000000
00000000000000001111000000000000000000000000000000000000000000000000000000000000000000000000000000000
00000000000000001111000000000000000000000000000000000000000000000000000000000000000000000000000000000
00000000000000000000000000000000000000000000000000000000000000000000000000000000000000000000011111100
00000000001111111111000000000000000000000000000000000000000000000000000000000000000000000000011111100
00000000000000000000000000000000000000000000000000000000000000000000000000000000000000000000011111100
00000000000000000000000000000000000000000000000000000000000000000000000000000000000000000000011111100
00000000000000000000000000000000000000000000000000000000111111111111111111111111111111111000011111100
00000000000000000000000000000000000000000000000000000000111111111111111111111111111111111000000000000
00000000000000000000000000000000000000000000000000000000111111111111111111111111111111111000000000000
00000000000000000000000000000000000000000000000000000000111111111111111111111111111111111000000000000
00000000001111111111000000000000000000000000000000000000111111111111111111111111111111111000000000000
00000000000000001111000000000000000000000000000000000000111111111111111111111111111111111000000000000
00000000000000001111000000000000000000000000000000000000111111111111111111111111111111111000011111100
00000000000000001111000000000000000000000000000000000000111111111111111111111111111111111000011111100
00000000000000000000000000000000000000000000000000000000111111111111111111111111111111111000011111100
00000000000000001111000000000000000000000000000000000000111111111111111111111111111111111000011111100
00000000000001001111000000000000000000000000000000000000111111111111111111111111111111111000011111100
00000000000000001111000000000000000000000000000000000000111111111111111111111111111111111000000000000
00000000000000000000000000000000000000000000000000000000111111111111111111111111111111111000000000000
00000000000000001111000000000000000000000000000000000000111111111111111111111111111111111000000000000
00000000000000001111000000000000000000000000000000000000111111111111111111111111111111111000000000000
00000000000000001111000000000000000000000000000000000000111111111111111111111111111111111000000000000
00001000000000000000000000000000000000000000000000000000111111111111111111111111111111111000011111100
00000000000000000000000000000000000000000000000000000000111111111111111111111111111111111000011111100
00000000000000000000000000000000000000000000000000000000111111111111111111111111111111111000011111100
00000000000000000000000000000010001100000000000000000000111111111111111111111111111111111000011111100
00000000000001000000000000000011100011000000000000000000111111111111111111111111111111111000011111100
00000000000000000000000000000011111100000000000000000000000000000000000000000000000000000000000000000
00000001000000000000000000000011000011000000000000000000000000000000000000000000000000000000000000000
00000000000000000000000000000000001100000000000000000000000000000000000000000000000000000000000000000
00000000000000000000000000000001000000000000000000000000000000000000000000000000000000000000000000000
00000000000000000000000000000000000010000000000000000000000000000000000000000000000000000000000000000
00000100000000000000000000000000010000000000000000000000000000000000000000000000000000000000000000000
00000000000000000000000000000000000000000000000000000000000000000000000000000000000000000000000000000
00000000000000010000011111100000000000000000000000000000000000000000000000000000000000000000000000000
11100000000000010000011111100000000000000000000000000000000000000000000000000000000000000000000000000
11100000000000000000111111111100000000000000000000000000000000000000000000000000000000000000000000000
00000000000000000000000000000000000000000000000000000000000000000000000000000000000000000000000000000
00000000000000000000000000000000000000000000000000000000000000000000000000000000000000000000000000000
00000000000000000000000000000000000000000000000000001111111111111111111111111111111111111111111111100
00000000000100000000110000000000000000000000000000001111111111111111111111111111111111111111111111100
00000000000000000000110000000000000000000000000000001111111111111111111111111111111111111111111111100
00000000000000000000111000000000000000000000000000001111111111111111111111111111111111111111111111100
00000000000000000000001000000011100000000000000000000000000000000000000000000000000000000000000000000
00000000000000000000000100000011100000000000000000000000000000000000000000000000000000000000000000000
00001000000000000000000000000000000000000000000000000000000000000000000000000000000000000000000000000
00000000000000000000000000000011111111111111111111111111111111111111111111111111111111111111111111110
00000000000100000000000000000011111111111111111111111111111111111111111111111111111111111111111111110
00000000000000000000000000000000000000000000000000000000000000000000000000000000000000000000000000100
00000000000000000000000000000000000000000000000010000000000000000000000000000000000000000000000000000
00000000000000000000000000000000000001000000000000001000000000000000010000000001000000000000100000000
00000000000000000000000010000000000000000000000000000000000000000000000000000000000000000000000000000
00000000010000000000000000000000000000000000000000000000000100000000000000000000000000000000000000000
10000000001000000000100000000010000000011000010000100000000010000000001000000000100010000010000000000
00000000000000000000000000000000000000000000000000000000000000000000000000000000000000000000000000000
00000000000000000000000000000000000000000000000000000000000000000000000000000000000000000000000000000
00000000000000000000000000000000000000000000000000000000000000000000000000000000000000000000000000000
00000000000000000000000000000000000000000000000000000000000000000000000000000000000000000000000000000