00000000000000000000000000000000000000000000000000000000000000000000000000000000000000000000000000000
11111111100111100000000000000000000000000000000000000000000000000000000000000000000000000000000000000
11111111100111100000000000000000000000000000000000000000000000000000000000000000000000000000000000000
11111111000111100000000001000000000000010000000000000000100000000000100000000110000001000000000011000
11111111101111110000000000000000000000000000000000000000000000000000000000000000000000000000000001000
11111110000111111111111111110111111111111111111111000001111111111111111111111111111111111111111111110
11111100010111111111111111111111111111111111111111000001111111111111111111111111111111111111111111110
11111000000011111111111111111111111111111111111111000001111111111111111111111111111111111111111111110
11110010000001111111111111110111111111111111111111000001111111111111111111111111111111111111111111110
11100000000000111111111111110111111111111111111111000001111111111111111111111111111111111111111111110
11001000000000000000000000000000000000000000000000000000000000000000000000000000000000000000000000000
00000000000000000000000000000000000000000000000001000000000000000000000000000000000000000000000000000
00000000100000000000000000000000000000000000000001000000000000000000000000000000010000000000000000000
00010000000000000000000000000000001000000000000001000000100000000000000000000000000000000000000000000
00000000000000000000000000000000000000000000000001000000000000000000000000000000000000000000000000000
00000000000000000000000000000000000000000000000001000000000000000000000000010000000000000000000000000
00000000000000000000000000000001111000000000000001000000000000000000000010000000000010000000000000000
00000000000000000000000000000001111000000000000000000000010000000000000000000000000000000000000000000
00000000000000000000000000000000111000000000000100000000000000000000000000010000000000000000000000000
00000000000000000000000000000000000000000111110000000000000000000000000000000000000000000000000000000
00000000000000000000000000000000000000000000000000000000000000000000000000000000111110000000000000000
00000000000000000000000000000000000000000000000000000000000000000000000000000001111110000000000000000
00000000010000000000000000000000000000000000000000000000000000000000000000000000111110000000000000000
00000000000000000000000000000000000000000000000000000000000100000000000000000100111110000000000000000
00000000000000000000000000000000000000000000000000000000000000000000000000000100111110000000000000000
00000000000000000000000000000000000111110000010000000001000000000000000000000000111110000000000000000
00000000000000000000000000000000010111110000000000000001000000000000000000000010111110000000000000000
00000000000000000000000000000000000111110000000000000001000000000000000000000000111110000000000000000
00000000000000000000001111111000000111110000000000000001000000010000000000000000111110000000000000000
00000000000000000000001111111000000111111110000000000001000000000000000000000000111110000000000000000
00000001110000000000001111111000000001111110000000000001000000000000000000000001111110000000000000000
00000001110000000000001111111000000000111110000000000001000000000000000000000000111110000000000000000
00000000000000000000000000000000000000011110000000000001000000000000000000000000111110000000000000000
00000000000000000000000000000000000000111110000000000001000000000000000000000010111110000000000000000
00000000000000000000111100000000000000000000000000000000000000000000000000000000111110000000000000000
00000000010000000000000000000000000000000000000000000000000000000000000000000000111110000000000000000
00000000000000000000000000000000000000000000000000000000100000000000000000000000111110000000000000000
00000000000000000000000000000000000001000000000000000000000000000001000000000100111110000000000000000
00000000000000000000000000000000000000000000000000000000000000000000000000000001111110000000000000000
00000000000000000000000000000000000010000000000000000000000000000000000000000000111110000000000000000
00000000000000000000000000000000000001000000000000000000000000000000000000000000111110000000000000000
00000000000000000000000000000000000000000000000010000000000000000000000000000100111110000000000000000
00000000000000000000000000000000000000000000000000000000000000000000000000000000111110000000000000000
00000000000001111000000000000000000000000000000000000000000010000000000000000010111110000000000000000
00000000000001111000000000000000000000000000000000000000000110000000000000000000111110000000000000000
00000000000000000000000000000000000000000000000000000000000000000000000000000000111110000000000000000
00000000000000000000000000000000000001000000000000000000000000000000000000000001111110000000000000000
00000000000000000000000000000000000000000000000000000000000000000011111111111110111110000000000000000
01111100000000000000000000000000000000000000000000000000000000000011111111111111111110000000000000000
00000000000000000000000000000000000000000000000000000000000000000000000000000000000000000000000000000
00000000000000000000000000000000000000000000000000000000000000000000000000000000000000000000000000000
00000000000000000000000000000000000000000000000000000000000000000000000000000000000000000000000000000
00000000000000000000000000000111111000000000000001000000000000000011111111111111111110000000000000000
00000000000000000000000000011000000000000000000000000000000000000011111111111111111110000000000000000
00000000001000000000000000000000000000010000001100000000000000000000000000010000111110000000000000000
00000000000000000000000000000000000000000000001000000000000000000000000000000100111110000000000000000
00000000000000000000000000000000000000000000000000000000000000000000000000000010111110000000000000000
00000000000000000000000000000000000000000000000000000000000000000000000000000000111110000000000000000
00000000000000000000000000000000000000000000000000000000000000000000000000000000111110000000000000000
00000000000000000000000000011111000000000000000000000000000000000000000000000001111110000000000000000
00000000000000000000000000011111000000000000000000000000000000000001000000000100111110000000000000000
00000000000000000000000000011111000011110000000000000000000000000000000000000000111110000000000000000
00000000000000000001000000011111000011110000000001000000000000000000000000000000111110000000000000000
00000000000000000000000000000000000001110001110000000000000000000000000000000000111110000000000000000
00000000000000000000000000000000000000000000000000000001000000000000000000000010111110000000000000000
00000000000000000000000000000000000000000000000000000000000000000000000000000000111110000000000000000
00000000000000000000000000000000000000000000000001000000000000000000000000000000111110000000000000000
00000000111110000000000000000000000000000000000100000000100000000000000000000001111110000000000000000
00000011111111000000000000000000000000000000000000000000000000000000000000000000111110000000000000000
00000011111111000000000000000000000000000000000000000000000000000000000000000100111110000000000000000
00000111111111000000000000000000000000000000000000000001000000000000000000000000111110000000000000000
00000111111111000000000000000000000000000000000000000000010000000000000000000000111110000000000000000
00000111111111000000000000000000000000000000000000000000000000000000000000000010111110000000000000000
00000111111111100000000000000000000000000000000000000000000000000000000000000010111110000000000000000
00000111111111100000000000000000000000000000000001000000000000000000000000000000111110000000000000000
00000111111111100000000000000000000000000000010001000000000000000000000000000100111111000000000000000
00000011111111000000000000000000000000000000100001000000000000000000000000000001111111100000000000000
00000000000000010000000000000000000000000000001001000000000000000000000000000000111111110000000000000
00000000000110000000000000000000000000000000000001000000000000000000000000000000111111110000000000000
00000000000000000000000000000000000000000000000001000001110000000000000000000000111110000000000000000
00000000000000000000000000000000000000000000000001000001110000000000000000000100111110000000000000000
00000000000000000000000000000000000000000000100001000001110000000000000000000000111110000000000000000
00000000000000000000000000000000000000000000000001000000000000001000000000000000000000000000000000000
00000000000000000000000000000000000000000000000001000000000000011000000000000000000000000000000000000
00001000000000000000000000000000000000000000000001000000000000001111000000000000000000000000000000000
00000000000000000000000000000000000000000000000000000000000000001111000000000000000000000000000000000
00000000000000000000000000100010001110000000000000000000000000001111000000000000000000000000000000000
00000000000000000000000000100000001111100000000000000000000000000011100000000000100000000000000000000
00000000000000000000000000100000000111100000000000000000000000000000110000000000000000000000000000000
00000000000000000000000000100000000111100000000000000000000000000000110000000000000000000000000000000
00000000000000000000000000100000000000000000000001100000000000000000001000000000000000000000000000000
00000000000000000100000000100000000000000000000001100000000000000000000000000000000000000000000000000
00000000000000000000000000100000000000000000000001100000000000000000000000000000000000000001100000000
00000000000000000000000000000000000000000000000000000000000000000000000000000000000000000000010000000
00000000000000000000000000000000000000000000000000000000000000000000000000000000000000000000000000000
00000000000000000000000000000000000000000000000000000000000000000000000000000000000000000000000000000
00000000000011000000000000000000010000000000000000000000000000000000000000000000000000000000000000000
00000000010000000001000001000100000000010000000001000000000100000000010000000001000000000100000000000
00000000000000000000000000000000000000000000000000000000000000000000000000000000000000000000000000000
00000000000000000000000000000000000000000000000000000000000000000000000000000000000000000000000000000
00000000000000000000000000000000000000000000000000000000000000000000000000000000000000000000000000000
00000000000000000000000000000000000000000000000000000000000000000000000000000000000000000000000000000