00000000000000000000000000000000000000000000000000000000000000000000000000000000000000000000000000000
00000000000000000000000000000000000000000000000000000000000000000111111111111111111111111111111111110
00000000000000000000000000000000000000000000000000000000000000000111111111111111111111111111111111110
00000100000000000000000000000000011111000000000000000000000000000111111111111111111111111111111111110
00000000000000000000000000000000011111100000000000000000000000001011111111111111111111111111111111110
00000000000000000000000000000000001111110000000000000000000000000011111111111111111111111111111111110
00000000000000000000000000100000000111110000000000000000000000000011111111111111111111111111111111110
00000000000000000000000000000000000000000000000000000000000000000001111111111111111111111111111111110
00000000000000000000000000000000000011110000000000000000000000000000111111111111111111111111111111110
01000000000000000000000000000000000011111100000000000000000000000000011111111111111111111111111111110
11111111111111111110111111111100000011111110000000000000000000000000001111111111111111111111111111110
11111111111111111110111111111100000001111111100000000000000000000000010111111111111111111111111111110
11111001000000000000000000001110000000111111110000000000000000000000000001111111111111111111111111110
11110000000000000000000000000000000000011111111000000000000000000000000000001111111111111111111111110
11100000000000000000000000000000000000001111111100000000000000000000000000000111111111111111111111110
11010011111110000111111100000000100000000011111100000000000000000000000000000001111111111111111111110
10000011111110000111111100000000000000000001111100000000000000000000000000000000011111111111111111110
10000011111110000111111100000000000000000001111110000000000000000000000000001000001111111111111111110
00000011111110000111111100000001000000000000111110000000000000000000000000000000000111111111111111110
00000011111110000111111100000000000000000000111110000000000000000000000000000000000011111111111111110
00000011111110000111111100000000000000000000111111000000000000000000000000000000000001111111111111110
00000011111110000111111100000011111111110000011111000000000000000011000000000000000100111111111111110
00000011111110000111111100000000000000000100011111000000000000000000000000000000000000011111111111110
00000000000000000000000000000000000000000000011111000000000000000000000000000000000000001111111111110
00000000000000000000000000000000000000000000011111000000000000000000000000000000000000000011111111110
00000000000000000000000000000000000000000000011111000000000000000000000000000000000000000000111111110
00000000000000000000000000000000000000000010011111000000000000000000000000000000000000000000001111110
00000000000000000000000000000000000000000000011111000000000000000000000000000000000000000000000000110
00000011111110000111111100001111111000000100011111000000001000000000000000000000000000000000000000000
00000011111110000111111100001111111000000000011111000000000000000000000000000000000000000000000010000
00000011111110000111111100001111111000000000011111000000000000000000000000000000000000000000000000000
00000011111110000111111100001111111000001111111111000000000000000000000000000000000000000000000000000
00000011111110000111111100001111111000000000011111001111111111111111111111111111110000000000000000000
00000011111110000111111100001111111000000000011111001111111111111111111111111111110000000000000000000
00000011111110000111111100001111111000000000011111001111111111111111111111111111110000000000000000000
00000011111110000111111100001111111000000000011111000000000000000000000000000001110000000000000000000
00000000000000000000000000000000000000000000011111111111111111111111111111111101110000010000000000000
00000000000000000000000000000000000000000000011111000000000000000000000000111101110000000000000000000
00000000000000000000000000000000000000000000011111000000000000000000000000011101110000000000000000000
00000000000000000000000000000000000000000000011111000000000000000000000000001101110000000000000000000
00000000000000000000000000000000000000000000011111001111100111110000000000000001110000000000000000000
00000000000000000000000000000000000000000000011111001111100111110000000000000001110000000000000000000
00000000000000000000000000000000000000000000011111001111100111110000000000000001110000000000000000000
00000000000000000000000000000000000000000000011111000000000000000000000000000001110000000000000000000
00000000000000000000000000000000000000000000011111000000000000000000000000000001110000000000000000000
00000000000000000000000000000000000000000000011111000000000000000000000000000001110000000000000000000
00000000000000000000000000000000000000000000011111000000000000000000000000000001110000000000000000000
00000000000000000000000000000000000000000000011111000000000000000000000000000001110000000000000001000
00000000000000000000000000000000000000000000000000000000000000000000000000000001110000000000000000000
00000000000000000000000000000000000000000000000000000000000000000000000000000000000000000000000000000
00000000000000000000000000000000000000000000000000000000000000000000000000000000000000000000000000000
00000000000000000000000000000000000000000000000000000000000000000000000000000000000000000000000000000
00000000000000000000000000000000000000000000011111000000000000000000000000000001110000000000000000000
00000000000000000000000000000000000000000000011111000000000000000000000000000001110000000000000000000
00000000000000000000000000000000000000000000011111000000000000000000000000000001110000000000000000000
00000000000000000000000000000000000000000000011111000000000000000000000000000001110000110000000000000
00000000000000000000000000000000000000000000011111000000000000000000000000000001110000000000000000000
00000000000000000000000000000000000000000000011111000000000000000000000000000001110000000000000000000
00000000000000000000000000000000000000000000011111000000000000000000000000000001110000000000000000000
00000000000000000000000000000000000000000000011111000000000000000000000000000001110000000000000000000
00000000000000000000000000000000000000000000011111000000000000000000000000000001110000000000000000000
00000000000000000000000000000000000000000000011111000000000000000000000000000001110000000000000000000
00000000000000000000000000000000000000000000011111000000000000000000000000000001110000000000000000000
00000000000000000000000000000000000000000000011111000000000000000000000000000001110000000000000000000
00000000000000000000000000000000000000000000011111111111111111111111111111111101110000000000000100000
00000000000000000000000000000000000000000000011111000000000000000000000000000001110000000000000000000
00000011111110000111111100001111111000000000011111001111111111111111111111111111110000000000000000000
00000011111110000111111100001111111000000000011111001111111111111111111111111111110000000000000000000
00000011111110000111111100001111111000000000011111001111111111111111111111111111110000000000000000000
00000011111110000111111100001111111000000000011111000000000000000000000000000000000000000000000000000
00000011111110000111111100001111111000001111111111000000000000000000000000000000000000000000000000000
00000011111110000111111100001111111000000000011111000000000000000000000000000000000000000000000000000
00000011111110000111111100001111111000000000011111000000100000000000000000000000000000000000000000000
00000000000000000000000000000000000000000010011111000000000000000000000000000000000000000000000000000
00000000000000000000000000000000000000000000011111000000000000000000000000000000000000000000000000000
00000000000000000000000000000000000000000000011111000000000000000000000000000000000000000000000001000
00000000000000000000000000000000000000000010011111000000111000000000000000000000000000000000000000000
00000000000000000000000000000000000000000000011111000011111000000000000000000000000000001000000000000
00000011111110000111111100000000000000000000011111000011111000000000000000000000000000000000000000000
00000011111110000111111100000000000000000100011111100011111000000000100000000000000000000000000000000
00000011111110000111111100000011111111110000001111100000000000000000000000000000000000000000000000000
00000011111110000111111100000011111111110000001111100000000000000000000000000000000000000000000000000
00000011111110000111111100000000000000000000001111100000000000000000000000000000000000000000000000000
00000011111110000111111100000001000000000000001111100000000000000000000111111110000000000000000000000
00000011111110000111111100000000000000000000001111100000000000001100001111111111000000000000000000000
00000011111110000111111100000000100000000000001111100010000000000000011111111111100000000000000000000
10000000000000000000000000000000000000000000001111110000000000000000011111111111100000000000000000000
11010000000000000000000000000000010000000000000111110000000000000000011111111111100000000000000000000
11110000000000000000000000000000000000000000000111110000000000000000011111111111100000000000000000000
111111111111000111111111111111100000000000000000111110000000000000000011111111111100000000000000000000
11111111111100111111111111111101000000000000000111110000000000000000011111111111100000000000000000000
00000000000000000000000000000000000000000000000111110000000000000000011111111111100000000000000000000
00000000000000000000000000000000000000000000000111110000000000000000011111111111110000000000000000000
00000000000000000000000000000000000000000000000111110000000000000000011111111111101000000000000000000
00000000000000000000000000000000000000000000000111111000000000000000001111111111000000000000000000000
00000001000000000000000000000000000000000000000011111000000000000000000111111110000000000000000001000
00000000000000000000000000000000000000000000000011111000000000000000000000000000000000000000000000000
00000000010111100001000000000100000000011000001111111000000100000000010000000001000000000100000000010
00000000000000000000000000000000000000000000000000000000000000000000000000000000000000000000000000000
00000000000000000000000000000000000000000000000000000000000000000000000000000000000000000000000000000
00000000000000000000000000000000000000000000000000000000000000000000000000000000000000000000000000000
00000000000000000000000000000000000000000000000000000000000000000000000000000000000000000000000000000